******************************************
*                                        *
*                                        *
*                                        *
*                                        *
*********  *******************************
*                                        *
*                                        *
*                                        *
*                                        *
****************  ************************
*                                        *
*                                        *
*                                        *
*                                        *
********  ********************************
*                                        *
*                                        *
*                                        *
*                                        *
*********************  *******************
*                                        *
*                                        *
*                                        *
*****************************FF***********